████████████████H████████████████████
█             X                    ◀︎█
█             X                    ◀︎█
█             X                    ◀︎█
█           ████████        █ █ █► ◀︎█
█                           █ █X█► ◀︎█
█                           █ █ █►$◀︎█
█                           █X█ █►$◀︎█
█           █               █ █ █►$◀︎█
█           ████████        █ █ █►$◀︎█
█                           █ █ █►$◀︎█
█                           █ █ █►$◀︎█
█                             █    ◀︎█
████████████████████████████████   ◀︎█
█                           █    ♨︎  █
█ ♨︎        B    X           █  $$$  █
█████████████████████████████████████
